1PL — first person plural
2PL — second person plural
3PL — third person plural
1SG — first person singular
2SG — second person  singular
3SG — third person singular
ABL — ablative case
ACC — accusative case
ADJ — adjective
ADV — adverb
AUX — auxiliary
C — common gender
COMP — complementizer
CONJ — conjunction
CONN — connective
DAT — dative case
DAT—LOC — dative-locative case
DEM — demonstrative pronoun
EMF — emphatic
EMPH — emphatic
ENCL — enclitic
GEN — genitive case
IMP — imperative mood
IMPF — imperfect
INDEF — indefinite pronoun
INF — infinitive
INST — instrumental case
INSTR — instrumental case
LOC — locative case
MED — medium
N — noun
NEG — negative
NOM — nominative case
NUM — cardinal
P — preposition (postposition)
PART — particle
PERS — personal
POSS — possessive pronoun
PL — plural
PRON — pronoun
PRS — present tense
PRT — preterite
PRV — preverb
PST — past tense
PTCP — participle
REFL — reflexive
REL — relative pronoun
SG — singular
Q — question word
QUOT — quotative
V — verb
VOC — vocative case
